15
15
###############
#             #
#             #
#             #
#         **  #
#       II    #
#   W  K      #
#             #
#   IIIIIIII  #
#             #
#    *****    #
#             #
#             #
#             #
###############