17
21
#####################
#                   #
#                   #
#      #####        #
#      #T  #        #
#         ##        #
#                   #
#      S       @    #
#                   #
#                   #
#                   #
#     KKKKKKKKKK    #
#                   #
#                   #
#                   #
#                 K #
#####################
