17
21
#####################
#####################
#####  %    T  ######
######       ########
######         ######
##       KK     #####
#       K        ####
###     K         ###
#          @        #
####         ########
#####   KKKK  #######
#######     #########
#######    ##########
###         #########
###KKKKKKK###########
#####################
